NO ./textures/red.xpm
SO ./textures/red.xpm
WE ./textures/red.xpm
EA ./textures/red.xpm
F 220,100,0
C 225,30,0
111111111               
100000101               
110S00101               
100000001 1111111111111
100011101110000000000001
100010000000111100000001
1111111111111  111111111