111111111
10000W001
100S00001
1000000N1
111111111