NO textures/red.xpm
SO textures/red.xpm
WE textures/red.xpm
EA textures/red.xpm
F 220,100,0
C 225,30,0
111111111111111111111
100010000000101000001
101010101011101111101
101010101000000010001
101110101111111010111
101010101000000010001
101011101010111111101
100010001010000010001
111010111110111010101
100010101000101000101
101110101011101011111
100000100000W01000001
111111111111111110111
100000101000001000001
111011101110111011101
100000100000001000101
111011111011111010101
101010000010000010101
101010101010111111101
100000101000000010001
111111111111111111111
