1111111
1110101
111W101
1000001
1000001
1111101
    111