NO ./textures/red.xpm
SO ./textures/red.xpm
WE ./textures/red.xpm
EA ./textures/red.xpm
F 0,0,139
C 173,216,230
1111111111
1000000S01
1000100001
1010100001
1010100001
1010001001
1000001001
1000001001
1000000001
1111111111
